XXXXXXXXXXXXXXXXXXXXXXXXXXXXXX
X P           X    S  X      X
XXX           X       X     TX
XXX           XX XXXXXX      X
XXX S                        D
XXXXXXXXXXXXXXXXXXXXXXXXXXXXXX