XXXXXXXXXXX
X  P   X FX
X      X  X
XXXX   X  X
X  X   X  X
X  X   X  X
X         X
X         X
X  XXXXXXXX
X         X
X        OX
XXXXXXXXXXX